0
0020,0020
0020,0020
3
0003,0008
0005,0005
 1 1 1 1 1
 1 1 1 1 1
 1 1 1 1 1
 1 1 1 1 1
 1 1 1 1 1
0010,0003
0003,0008
 1 1 1
 1 . 1
 1 1 1
 1 . 1
 1 1 1
 1 1 1
 1 1 1
 1 1 1
0000,0017
0020,0003
 1 . . . . . . 1 . . . . 1 . . . . . . 1
 1 . . 0 0 0 0 0 0 . . . . . . . . . . .
 1 1 1 1 1 1 1 1 1 1 1 1 1 1 1 1 1 1 1 1